""""""""""""""""""""""""""""""""""""""""""""""""""""
    ##   ##  #######  ##       ##       ########
    ##   ##  ##       ##       ##       ##    ##
    #######  #######  ##       ##       ##    ##
    ##   ##  ##       ##       ##       ##    ##
    ##   ##  #######  #######  #######  ######## 
""""""""""""""""""""""""""""""""""""""""""""""""""""
