""""""""""""""""""""""""""""""""""""""""""""""""
    ##   ##  #######  ##       ##       ########
    ##   ##  ##       ##       ##       ##    ##
    #######  #######  ##       ##       ##    ##
    ##   ##  ##       ##       ##       ##    ##
    ##   ##  #######  #######  #######  ######## 
""""""""""""""""""""""""""""""""""""""""""""""""